OOOOOOOOOOOOO
O   O  B  P O
O P O   OOOOO
         2
O1 OOOO 4   O
O   3    OP O
OOOOOOOOOOOOO
